видях: видяха
переизобретать: переизобрести
мобильный: мобильную мобильная мобильное
прошлогодний: прошлогодним прошлогодней
марков: марков
соответсвенно: соответсвенно
порешать: порешали
фишка: фишками
гиг: гиги
кеш: кэше
скора: скоре
быть: будут будешь Будут
ненужный: ненужных
точный: Точных точен Точные
бессилие: бессилие
диафрагма: диафрагме
размер: размеров
пострадать: пострадали
охлаждаться: охлаждаться
невыгодно: невыгодно
фронталка: фронталке
таять: Тай
невероятно: невероятно
система: системами системы
опаздывать: Опаздываете
профиль: профилю
засвет: засветы
ока: оке
десяток: десятков десяток
неудачный: неудачном
хотяб: хотяб
казаться: кажись
лазить: лазят
включать: включающем включил
будущий: будуща
хороший: хорошую хорошее лучшему хорошая Хорошая хорошем
элегантно: элегантнее
файрфокс: Файрфокс
царапаться: царапаться
многопоточный: многопоточный многопоточной
медленно: медленней медленнее
бесполезный: бесполезный бесполезным
тяга: тяга
печатать: Печатать печатать
последний: Последние последнем последние последнюю Последний последним
толстый: толстых
третий: Третье третьих третьем
скучный: скучные
утверждать: утверждает
описание: описанию
пора: Порой пор
самсун: самсун
измерение: измерением измерения
будка: будкой
искусственный: искусственной
полезный: полезной Полезный полезное полезный полезны полезен
сполна: сполна
устанавливать: установи установило
воплощать: воплотить
подарить: подарить подарила
затемнение: затемнения
закруглять: закруглена
неприятность: неприятностью
оценивать: оценить оценил
случитс: случитс
основной: основной основное
задний: заднюю
полюбить: полюбить
ких: ких
премия: премии
прекрасный: прекраснейшую прекрасен прекрасные
тъш: тъш
повлиять: повлияли повлиять
ждать: ждешь Жду ждать ждем
тайтлов: тайтлов
курить: курил
плюнуть: плюнув
показатель: показателю
столько: столько
нищий: нищие
благодарность: благодарностью
кликать: кликая
лицуха: лицухах
тизер: тизеры тизеров
хрение: хренью
конфигурация: конфигурациях Конфигураций
вывод: вывод выводы
лишний: лишние
дисплей: дисплей дисплея дисплее дисплеем
цифровой: цифрового цифровой цифровую
мертвый: мертва
бюджетный: бюджетная бюджетных бюджетного бюджетно
имитировать: имитирует
эпидемия: эпидемию
пхать: пхать
полно: полно
снимать: снял снятый сняв Снимаешь снято
заплатить: заплатить
прямоугольник: прямоугольников
сегмент: сегментом
пямять: пямяти
улучшать: улучшают
наследие: наследие
различимый: различимы
помечать: помечено
отзыв: отзывах
утилита: утилиты
долларовый: долларового
прикручивать: прикручивать
рязань: Рязани
цель: цели
симка: симки
посмотреть: Посмотрите посмотреть посмотрит посмотрят
отношение: отношению
слагать: сложен сложил
жабак: жабак
проапгрейд: проапгрейд
аналогичный: аналогичное аналогичной
отправлять: отправляешь отправил отправленной
убирать: убираешь убрал
каефа: каеф
необычно: необычно
майбенбен: Майбенбена майбенбена
мегапиксельный: мегапиксельной мегапиксельный мегапиксельную
клиент: клиентов
неологизм: неологизм
подключаться: подключиться подключаться
флагман: флагманы
взять: взять возьми возьму Возьму
прошивка: прошивкой прошивками
идеальный: идеальную
жидкий: жидкий
фаил: фаилы
любой: любое Любые любом
точка: Точка
вообще: вообще
черный: черном
говорить: говорите говорят говорим
втыкать: Втыкаешь
понабрать: понаберут
крекер: крекер
трижды: трижды
бывать: бывал
бесконечность: бесконечности
фактор: фактора
висеть: висеть
монолит: монолит
вносить: внесены
шильдик: шильдик Шильдик
гибернация: гибернацию
отличаться: отличаются
терпимый: терпимая
ссылка: ссылкой
тачпад: тачпад тачпаде
весить: весил
мегабайт: мегабайт
письмо: письмо
хрома: хрома
условие: условии условий условиях
заканчивать: закончит
складной: складная складные
точечный: точечный
четкий: четкий
обзаводиться: обзавелась
ветка: ветки
совместимый: совместимы совместимый
признавать: признала признали
эпл: Эпл
кот: кот
поликарбонат: поликарбоната
большинствп: большинствп
абсолютно: Абсолютно
заканчиваться: Закончатся закончатся
бытовой: бытовую
красивый: красивый красивее красивом
комплектующий: комплектующие комплектующими
подборка: подборку
траншион: Траншион
первый: Первым первые
вкусно: вкусно
хоспад: хоспаде
эстетично: эстетично
демонстрировать: демонстрировали
думать: думают думали
урезать: урезано урезан
кадр: кадров Кадры
расход: расход
алик: алика
статтер: статтерами
делать: делая делать
плохо: Хуже
присматриваться: присмотреться
совать: суют совать
раскладываться: раскладываются
звук: звуку звук звуке
дорога: дорогам
узкий: узкими
переживать: переживает
плойка: плойку
проживание: проживания
кумир: кумиры
расти: растет
попробовать: Попробую
выход: выходом выходе выход
приличный: приличная приличный приличным
чайник: чайники
цыпленок: Цыпленок
однако: Однако
противоречивый: противоречивое
железо: железом железу
люб: люб
выгорать: выгорал
изображение: Изображение
популярный: Популярные популярным
готовиться: готовится
предфлагман: предфлагман
разъем: разъемы
пятно: пятном
загнутый: загнутых
очевидно: Очевидно очевидно
кредит: кредита
напрашиваться: напрашивается
гипермаркетенговый: гипермаркетенговых
текстурирование: текстурирования
геймерский: геймерского
афоня: Афони
называть: называешь
вливание: вливаний
крайний: крайней
яюфъы: яюфъы
утроиства: утроиства
стресс: стресс
консультация: консультация
малый: малым
алтра: алтра
рождень: рождени
объективность: объективность объективности
судя: Судя
обязательно: обязательно
привычный: привычного
дикий: дикой дичайший
закрывать: закрыл закрывать
задумываться: задумываясь задумалась
писать: Пишут
открывать: открыли открыть
походный: походный
двойной: двойную двойными
набирать: набрал набираю набирать
свиномаска: свиномаска
оптический: оптические оптическая Оптический
владелец: Владельцы
кролик: Кролики
эпль: Эпль
постановление: постановление
ультимат: Ультимате
шифрование: шифрованием
объединяться: объединилась
отстаивать: отстаиваешь
свистящий: свистящему
оторватьс: оторватьс
двуручный: двуручные
неплохой: неплохи
бред: бред бредом
ифон: ифона Ифон
уверять: уверяю уверять
стараться: стараюсь стараются
динамик: Динамиков
стабильный: стабильный стабильную стабильной
понятно: понятно
презентабельный: презентабельный
вариант: вариантов
оригинальный: оригинальный
розетка: розетка
случайный: случайного
отображать: отображать
брехня: брехню
акий: акие
разбивать: разбить разбивать
середняк: середняками
бризер: бризером
десятый: Десятая
особенный: особенная
ролик: ролики
май: мае
планшет: планшетах планшетов
бук: буке бук
дофантазировать: дофантазировать
проводить: проводить Проводили
банальный: банальное
энергопотребление: Энергопотребление
чръряра: чръряр
макрообъектив: макрообъектив
строгий: строгий
корпоративный: корпоративный
ходьба: ходьбы
стартап: стартапа
фронтальный: фронтальна
встречаться: встречается
действие: действия
хейтята: хейтят
борзая: борзые
невероятный: невероятного
стественно: стественно
фюыую: фюыую
павербанк: павербанка
ноутбучный: ноутбучная
напрямую: напрямую
обычный: обычным обычна обычного обычном
ведень: ведени
неидеальный: неидеальных
антуту: антуту
бычок: бычки
средний: средний Средний
количество: количества
все: всеми
влага: влаги
защиток: защитку
эксперимент: экспериментов эксперименте Эксперимент
ход: Ход
распаковывать: распаковал
аппарат: аппаратов аппарата
глядеть: глядя
самый: Самое самые
тянуть: тянул
любимый: Любимый любимую
дорого: Дорого ДОРОГО
качественный: качественнее качественный качественной
чтень: чтени
японский: японское японский
качество: Качество качестве
несколько: несколькими нескольку
север: севере
среднебюджетник: среднебюджетники
вспоминаться: вспомнился
словоблудок: словоблудки
обновляться: обновляется обновятся
поездка: поездкой поездку поездки
влево: влево
отвратительный: отвратительна
косить: косили
идеал: идеале
ресета: ресет
портить: портить
посредственный: посредственного посредственную
жить: живут живет
взбудораживать: взбудоражен
бюджетник: бюджетнику бюджетник
возрат: возрат
периферия: периферией
обсуждать: обсуждаемые
акварель: акварели
смелый: смелый
десктоп: десктопа
непреевна: непревной
сидетьча: сидетьч
восьмой: восьмой
ютр: ютр
становиться: Стали
технический: Технические технические
подозревать: подозреваю
каста: каста
веббраузер: веббраузеров
известный: известный известна
регулярный: регулярные
подражание: подражание
кастомизированный: кастомизирован
хейтит: хейтит
фтшцхэшщ: фтшцхэшщ
охла: охл
топкейс: Топкейс
аккаунт: аккаунты
рассказывать: расскажут
картинка: картинку
чувачок: Чувачок
экшень: экшене
сетевой: сетевые
обнова: обнова
состояться: состоится состоялся
характеристика: характеристикам
апдейта: апдейты
выглядеть: Выглядит выглядит
оба: Оба
одинаковый: одинаковые одинаковое
музыкальный: музыкального музыкальный музыкальных Музыкальный
читать: читаем читали
порывать: порвет
код: кодом
взяться: взялись
раздавливать: раздавят
закрытие: закрытия
стим: Стим
ксяомишный: ксяомишные
подтверждать: подтверждено
полный: полную Полное полная полном
продукт: продуктом
прогон: прогон
фиксация: фиксации
хужий: хужее
лайн: лайн
кактус: кактус
посадить: посадит
торое: торое
ямал: ямале
промоматериал: промоматериалам
раскрывать: раскрывал
санлайт: Санлайта
аксессуар: аксессуары
шлейф: шлейф
нит: нит
затрата: затраты
откручивать: открутить
ыхт: ыхт
поэтому: поэтому
обрать: обрать
продажа: продажи
кектай: кектае
покатый: покатые
свергать: свергать
терабайт: терабайтом терабайта терабайты
подключать: Подключаемое Подключаю
физический: физическим
полностью: полностью
релизна: релизной
мегафон: Мегафон
возможность: Возможностей возможностью
определяться: определимся
официальный: Официальный официальное официальной официальном
эволюция: Эволюцию
лежать: лежали лежать
страница: страницы
плохой: плохого плохом
реализация: реализацию реализацией Реализация
флешка: флешками
рисовать: рисовал
энергия: энергией
лупастый: Лупастый
кожаный: кожаным
нужный: Нужен нужный
ссылаться: ссылаюсь
доступ: доступа
сходить: сходи
близко: близко
кликбейт: кликбейт
я: мной
париться: парился
премиальные: премиальных
немаловажный: немаловажно
стартовать: стартуют
проходняк: проходняк
сборка: Сборка
кошелек: кошельков
швейцарский: швейцарские
расстояние: расстояний
диоптрия: диоптриями
молодец: Молодцы
летний: летнем
штат: штатов
смартфонный: смартфонно
заверять: заверяет
входить: входит
принимать: принимать примет
каждый: каждые каждая
дорожить: дорожу
традиционный: традиционного традиционный
хонор: Хонором хонора Хонор
накопитель: накопители НАКОПИТЕЛЬ накопителей
ломаться: ломаться ломается
сша: сша
рной: рное
хотеть: хотят хочет
сделать: сделал сделаны сделавший
окурок: окурка
ретушь: ретуши
авито: Авито
граф: графу
интел: интеле
дым: дыма
фраза: фраза
машинка: машинка
результат: результат результаты результатам
приобретение: приобретение
ачество: ачество
пространственный: пространственный
анлок: анлок
юьярэш: юьярэш
жирнющий: жирнющий
одалживать: одалживали
зависеть: зависеть Зависит
устройство: устройство
время: временам
отклеиваться: отклеивался
щщи: щщи
идимо: идимо
какаха: Какаху
утапливать: утопленная
вызов: вызовами вызова
прошивать: прошивает
нцль: нцля
чувствовать: чувствует
лавандовый: лавандовой
проточный: проточный
рассказываться: рассказывается
заявлять: заявленных заявлен Заявленная заявляют
блин: блин
барин: барин
цветной: цветной
интересно: интересно поинтереснее
тестовый: тестовом
нахер: нахера
потратить: потратил
стабилизация: стабилизации
проводной: проводную проводные Проводная
потенциал: потенциал
давить: давить
преображаться: преобразился
положительный: положительными
широкоугольный: широкоугольный
холодный: холодным
схожий: схожи схожими схоже
бывший: бывшие
редь: реди
плмошь: плмошью
подготовка: подготовки
избыточный: избыточное
бок: бок
консерва: консерва
ида: ИДЕ иде
год: Лет годы год
индустрить: индустри
база: База
убогий: убогое
манька: Маньки
оснащать: оснащено оснащены
холдинг: холдинга
подсчитывать: подсчитано
кореец: корейцы
звонилка: звонилкой
метр: метр метрах
сследователь: сследователи
ипс: ИПС
приобретать: приобретают
файл: файлом
приемник: приемники
приставка: приставкой
специальный: специальным специальна специальной
знатный: знатное
провинция: провинции
покопаться: покопался
соблюдать: соблюдено
допускать: допускать
процент: процент
бенчмарка: бенчмаркам
длинный: длинные длинный
совершенство: совершенства
самообучение: самообучения
ъют: ъют
передняя: передней
уродство: уродство
баба: бабу
микробиолог: Микробиологам
неудобный: неудобной неудобным
менно: менно
август: августа
ваш: вашим ваши Вашего вашему
пример: пример примеры
астроинерциальный: астроинерциальную
прошка: прошек
продолжать: продолжат
собственность: собственности
производитель: производитель производителям
обращать: обращаю
резко: резко
режим: режимы режима Режим режимами
спэй: спэй
украиньськ: Украиньське
процессор: процессорами процессору
инфиникс: инфиникса
яблофон: яблофоном
околофлагман: околофлагманы
разумеется: разумеется
спасать: спасти
прилетать: прилетало
революционный: революционных
правый: правый правы
раскачка: раскачка
дух: духе
шить: шитый
китайфон: китайфонов китайфоном
маркетолог: маркетологов
ломить: ломят
поперхнуться: поперхнулся
исторический: исторического
обходить: обошли
затемнять: затемнить
надолго: надолго
итог: итоге итог
давать: давала дадут дало
тьфу: Тьфу
закон: закона Закон
глюк: Глюки
проц: процем процу процах
склад: складов
потреблять: потребляют
превращаться: превращались превратится
гадость: гадости
щьр: щьр
графический: графических графическому
дрожь: дрожь
констатировать: констатировать
никуда: никуда
отказываться: отказался откажусь отказаться
кнопочный: кнопочной
опускать: опущенное
бежать: бежать
премьер: премьер
битный: битный
практичность: практичностью
планирование: планированием
конец: конца
указываться: указывается
напоминать: напомнила
звать: зовут
давление: давлении
смс: смс
ребенок: детей Детей
скатиться: скатилась
таиланд: Таиланд
форточка: форточек
надежда: надежду
купертиновский: купертиновское
пушинка: пушинка
большой: большое
порт: порта
переманивать: переманил
установка: установкой установку
течение: течению
ночной: ночной
картеж: картежам
пакля: паклю
электрокара: электрокары
присваивать: присваивают
заниматься: занимаешься занимается
ощущать: ощущаешь
задача: задач
блокировщик: блокировщики
моча: мочу
запор: запором
паять: паял
озвучивать: озвучивают
увидеть: увидеть
страшный: страшная
длиннофокусник: длиннофокусника
таки: таки
палец: палец
униха: уних
настолько: Настолько
перспектива: перспектива
невысокий: невысокий
донатить: донатить
платный: платным
нагреваться: нагревается
структура: структура
внушительный: внушительная
участие: участия
приходить: приходишь Пришел
русь: Русь
телефонистка: телефонистки
периметр: периметру
оттуда: Оттуда
угу: Угу
новшество: новшество
исследователь: исследователи
удобный: удобное удобного
универсальный: универсальный
остаютс: остаютс
редми: редми
жать: жал
прикидывать: Прикинь
закладывать: закладывали заложенная
пленка: пленку
распил: распилом
ухо: уши
банка: банка
позорный: позорные
айфон: айфоны
раскручиваться: раскручивается
огрызок: огрызках Огрызок
турбобуст: турбобуст
заводской: заводских
остаеться: остаеться
папа: папа
некрасивый: некрасивые
ультраширик: ультраширик
связываться: свяжусь
издевательство: издевательство
самсунг: Самсунгу самсунгу
мышечный: Мышечная
шутер: шутера шутерах
ощущение: ощущение
микрофон: микрофон
происходить: происходящему
ыхтюь: ыхтюь
сказать: сказали Скажите сказано сказал Скажи скажет скажите
реалистичный: реалистичных
кстати: кстати
симулятор: симулятор симулятора
день: дню дня
прикрывать: прикрывать
внятно: Внятно
коллектив: коллективах
насыщеность: насыщеность
заговор: заговор
убого: убого
васян: васянов
тактильный: тактильными
простительный: простительно
добрый: Добрый доброго Доброй
комбинация: комбинацию
шесть: шести
верный: верный
функциональный: функциональных
смееться: Смееться смееться
дюйм: дюймов
хватать: хватать
пользоваться: Пользуюсь Пользовался пользовался пользуюсь
звимость: звимости
булочка: Булочка
просьба: просьбу
подержать: подержанный
лепить: лепить
вал: валу
потребность: потребностей
ущимляться: ущимляйся
целый: целой
метать: метал
уловка: уловка
мамкин: мамкины
прожорливо: прожорливее
адаптировать: адаптированной
довольный: доволен довольны
однодюймовый: однодюймовый
несмотря: Несмотря несмотря
плоский: плоском
ожидать: ожидаемые
справляться: справляться справляется
скачать: скачанный
пирсинг: пирсинг
простенький: простенькие простенькую
дындр: Дындра
надежно: надежнее
предъявлять: предъявлял
возгорание: возгоранию
представлять: представляет представил
фич: фича
сам: Сама
медный: медной медного
кнопка: кнопками кнопки
сплав: сплава сплавы
место: месте
купить: куплен Купил купленный
происшествие: происшествие
слетаться: слетаются
ножка: ножки
апскейлинг: апскейлинг
свого: свого
публикация: публикацию
пофиг: пофиг
рный: рный
шутка: шуток шутки Шутку
грелка: грелку
молодой: молодой
оооос: ООООС
забивать: забит
индикатор: индикатора
мультимедийный: мультимедийные
публика: публике публики
компактный: компактный Компактные
подхватывать: подхватят
модно: модно
язык: язык языке
дешеветь: дешевеют
ленивый: ленивый
приложение: Приложения
стадион: стадионе
утюг: утюг
списывать: списываю
проблема: проблемами
параметр: параметрами параметров
тормозной: тормознее
ток: Ток
немецкий: немецкий
асер: АСЕР
перевод: перевода
амса: амсу
завидно: завидно
мой: моих
секрет: Секрет
вечный: вечные
поддержка: поддержке Поддержка
ковровый: ковровую
закос: закосом
масштабирование: масштабирования
номер: номер
среднячок: среднячок
оверпрайснять: оверпрайснутых
разработчик: разработчиков
стимый: стимом
статья: статье
похожий: похожее похожие Похожая
миллионник: миллионник
смартфон: смартфонах
начало: начале начало
рендеры: рендеры
разница: Разница
ихний: ихними ихний
момент: момента
вырез: Вырез
наркотик: наркотиков
удобно: поудобнее
станционар: станционар
потребитель: потребители
накатить: накатили накатил
извращение: извращение
неторопливый: неторопливый
зацензуривать: зацензурены
художник: художников
петух: Петухов
симметрия: симметрия
двухлетний: двухлетней
свисток: свисток
сливать: сливали
студия: студий
чужой: чужой
фаерволла: фаерволла
деиствлять: деистви
запускать: запускает Запускаете
работать: работала работаете Работают
шасси: шасси
пара: парой
профит: профит
ьюцэю: ьюцэю
помешать: помешал
испортиться: испортятся
повышенный: повышенный повышенном
хозяин: Хозяин
внутри: Внутри
ходить: хожу ходили
оговариваться: Оговоримся
неуютно: неуютно
переименовывать: переименовали
памела: Памелой
починка: починки
попытка: попытка
находить: найдены найду
продвигать: продвинет продвинута продвинутые Продвинутые
восполнять: восполнить
привыкать: привыкли
выбирать: выбравших выбранном
вспомогательный: вспомогательным
амортизация: амортизации
оправдывать: оправдать
зан: зан
эмейзинг: эмейзинг
решать: решило
фоторамка: фоторамка
актуальный: актуальный
муж: муж
анонсировать: анонсированной
рекламный: рекламного
вспомнить: вспомню
сразу: Сразу
увеличивать: увеличен
плата: ПЛАТУ
находиться: находишься находится
выпускать: выпущенном
изогнутый: изогнуты
странный: Странный странного Странное
оценка: оценку
взаимодействие: Взаимодействие
присутствовать: Присутствует
колесо: колеса
готовый: готовое
беспроводной: беспроводных
грамм: граммов
бонус: бонусов
архив: архив
александра: Александры
хэтчбек: хэтчбек
финальный: финального финальный
восприятие: восприятия
материал: Материалы
второй: второго вторую второй второе
придушить: придушить
важный: важными важен
поделить: поделили
прямиком: прямиком
прежде: прежде
громкий: громких
канал: каналы
аромат: аромат
шляпа: шляпа
мутировать: мутируют
вропа: вропе
бре: бре
продавать: продала продам Продают
хуавей: Хуавей Хуавея
расцветка: Расцветка расцветку
близкий: ближайшее
суббренд: суббренд
прокачивать: прокачали
российский: российские российской Российской
восстанавливать: восстановит восстановленных
магия: магии
нравилс: нравилс
нутелла: нутеллу
чисто: чисто
брат: Брат
бездарь: бездари
инглише: инглише
стоять: стоящие
трястись: тряслась
люк: люки
тиран: тиранов
рядовой: рядового
остаток: остатки
етс: етс
приезжать: приехал приехала
менеджер: менеджерам менеджеры менеджеров Менеджеры
сериал: сериал
возникать: возникает
мама: маме
плавный: плавный
поверхность: поверхностью поверхность
классический: классические классическом
отверстие: отверстием
киви: Киви КИВИ
ворвалс: ворвалс
зуб: зубами
мембранный: мембранная
обрабатывать: обрабатывает обрабатывать обработан
наушник: наушников наушник
лицо: лица Лица
глючать: глючила
минутка: минутку
зен: зене
конструкция: конструкцию
озон: озон Озон
платить: платит
коробчонка: коробчонке
виться: вилось
заносить: заносит
агрегат: агрегат
защищать: защищена защищенные защитить
ыгл: ыгл
поровну: поровну
создавать: создано
переключень: переключени
орать: ору
восприниматься: воспринимается
нееее: Нееее
превращать: превращали превратит
вендор: вендора
картина: картина
тысяча: Тысяч
топовый: топовые
покоиться: покойся
разлука: разлуке
гра: гра
умножать: умножайте
оппа: оппы
полгода: полгода
почистить: почистить
гкам: Гкам гкам
гарри: Гарри
диагональ: диагональю диагональ
заверение: заверениям
лезть: лезете
дело: Дел
солнце: солнце
маням: маняме
единый: единое
оказываться: оказались окажется оказался
угол: углы углов
вылезать: вылезти вылезали
цивилизованный: цивилизованном
зарядный: зарядный
рейвенхольм: Рейвенхольм
стекольщик: стекольщик
активировать: активировал
душнил: душнилы
самопроизвольно: самопроизвольно
рные: рные
дывать: дывает
потерять: потерял
бог: бога
доказывать: доказать доказывать
никакой: Никаких
основный: основного
оттенок: оттенков
нужно: нужно
ретранслировать: ретранслировать
половинка: половинке
идея: идеям
крышка: крышка
бутлуп: бутлуп
понравиться: понравившийся понравиться
ломать: ломать
держаться: держалась
выбивать: выбил
пацан: пацанов
электроника: электроникой
получаться: получается Получившееся
узнавать: узнаешь узнаю
половина: половина половину
мощность: мощностей
знать: Знаю знаешь
фотофлагман: фотофлагманов фотофлагмана
яюьюуыр: яюьюуыр
обновление: обновлениями обновлением обновлений
поделать: поделать поделаешь
объявлять: объявлено объявили объявить объявят объявил
обмылок: обмылки
психануть: психанул
веселый: веселая Веселая
базовый: базовый базовую
камера: КАМЕРЫ Камера
маск: Маск
нативный: нативном
деньги: деньгам деньги
портативный: портативном
поколение: поколениях
ютуб: Ютуб
вылетать: вылетает
бумбокс: бумбокс
аналог: аналоги
мечтатель: мечтатели
феномен: феномену
палка: палки
касса: кассу
очевидный: очевидный
пофичасть: пофичастей
играть: играть
туалет: туалеты
покупать: покупают покупал покупаем покупаешь
вечно: Вечно вечно
быстрый: Быстрая быстрой быстрого
сталь: сталь
журналист: журналист Журналист
обладать: обладающий
испытывать: испытывал
меняться: менялся меняются
планка: планка
затем: затем
эмэйзинг: эмэйзинг
тков: тков
адский: адского
скрипеть: скрипит скрипящая
сильно: Сильно
полуподвальный: полуподвальные
грудь: груди
интерактивный: интерактивной
лимит: лимитами
комментарь: комментари
другой: других Другое
хомячок: хомячки
какой: какое
обморок: обморок
повышать: повышать
гульфик: гульфиком
сервисный: сервисной
удивляться: удивился
куртка: куртку
портретный: портретного
шанс: шанс
ульратонкий: ульратонких
книга: книгу
терминал: терминалы
выделять: выделить
автоматически: автоматически
мировой: мировым
крупный: крупнее
ерничать: ерничать
всесторонний: всестороннюю
снова: снова
тратить: тратишь
подразумевать: подразумевает подразумевают
программа: программой
щьютюую: щьютюую
злой: злые
подр: подр
сообщаться: сообщаются
слой: слоем
фшчхы: фшчхы
характерный: характерного
врываться: врывается
жело: жело
скринуть: Скриньте
дракон: дракон
низкий: низких низкое
лазер: лазером
чахнуть: чахнуть
смысл: смысл
фантазер: фантазер
пропорционально: пропорционально
крайность: крайности
уда: уде
воспроизводить: воспроизводит
последующий: последующих последующие
должный: Должны должны
быстро: быстро
неверный: неверные
функция: функции функциях функциями
основа: Основой основу
свифт: Свифт
гнездо: гнезде
вычет: вычетом
уважение: уважении
новость: новости новость
выводиться: выводится
трекер: трекера
текстовый: текстовый
масква: масквы
запрещать: запретят запрещать
идти: идут
фирма: фирмой фирмы
помогать: помогал помогает помогала
датчик: Датчик датчиков датчики
компьютерный: компьютерной
держать: держали держал
практика: практике
мтс: МТС
снеп: снепом
мышка: мышка мышку
располагать: расположен расположенные
ведущий: ведущим
стык: стыке
обозначать: обозначить
дебютировать: дебютировал
польза: пользы
вентилятор: Вентиляторы вентиляторами
скрытый: скрыта
выполнять: выполнять
пятый: пятом
мини: мини
разделять: разделит разделены
перегружать: перегруженная
презентация: презентация презентациях презентацию
пользование: пользовании
юсэютыхэш: юсэютыхэш
альголь: Альголя
сюз: Сюзе
китай: Китае
изволить: Извольте
креативный: креативно
малость: малость
присыпать: присыпали
обжигать: обжигает
стереотип: стереотип
выпячивать: выпячивает
обновлять: обновили обновить обновит обновляю
позиционироваться: позиционируются
коробка: коробки
недавний: недавнего
наносить: нанесена
инсайд: инсайду
нокиа: нокию
саморазряд: саморазряду
рыжий: рыжий
матрица: матрицей Матрица
мейкер: мейкер
спрятать: спрятаны
стрелок: стрелок
тинкбук: тинкбук
пайка: пайки
влагозащита: влагозащита
окружение: окружение
отменять: отменила
упоминать: упомянул
распознавание: распознавания
намекать: намекнули
иван: Иван
нотинга: нотинг
рождение: рождения
поддерживать: поддерживающими Поддерживая
клава: клава
проигрывать: проигрывает
маршрутка: маршрутка
преимущество: преимуществ
удивление: удивление
вывеска: вывеску
перегибаться: перегибается
банковский: банковскую
авт: авт
выпадать: выпадала
слышать: слышала слышать
эксклюзивный: эксклюзивной эксклюзивный
счет: счет
голосовой: голосового
свободный: свободно свободной
нужнн: нужнн
вериться: верится
тенденция: тенденциями
ассистент: ассистенты
откатить: откатили
магниевый: магниевым Магниевые
появляться: появиться появилось Появились появятся
зелененький: зелененькие
кейс: кейс кейсов
дурак: дурак
редмика: редмике
уголовный: уголовных
улучшение: улучшения улучшение
нихренный: нихрена
клавиша: Клавиши клавишей клавиши клавишах клавишами
дядюшка: дядюшка
акб: АКБ
электричество: электричества
стена: стенами
часы: часы
недорого: недорого
дешевый: дешевые
накрываться: накрылись
мессенджер: мессенджеров
спрашивать: Спрашиваю
классный: Классный
показывать: показали
хозяйский: хозяйского
прикосновение: прикосновении
мобил: мобил
настоящий: настоящем настоящая Настоящий настоящими
встроенный: встроенные
замусоривать: замусоренную
останавливать: остановило
обнаруживать: обнаружил
передавать: передайте
улучшалка: улучшалки
помещение: помещении
открывашка: открывашку
пинг: пинг пинга
забавно: Забавно забавно
кэльвин: Кэльвин
канальный: канального
гулять: гулять гуляли
младший: младший
вайтлистый: вайтлисты
непонятно: непонятно
трцэюь: трцэюь
сэкономить: сэкономить
покупатель: покупателям
лестница: лестнице
годный: годно
блочить: блочит
друж: Друже
ноль: нуле
план: план
бабочка: бабочка
островок: островка
минимум: минимум
поставщик: поставщиком поставщиками
архитектура: архитектуру
папка: папка
сид: сид
смочь: смогла сможешь
диван: диван диване
нежелание: нежелание
загибаться: загнулся
иметься: имеющиеся имелся
прикольный: прикольная
свойство: свойство
кольцо: кольцо
пофига: пофигу
обманывать: обмануть
ярлык: ярлык
статистика: статистику
уха: ухи
единственный: единственную
потребление: потребление
уменьшать: уменьшен
колонка: колонок
переписка: переписки
погнуться: Погнулся
один: одного
перешивать: перешитых
яблоко: яблока
свобода: свободы свобода
нормальный: нормален Нормальный
репа: репу
лавка: лавке
сокращать: сократить
скромный: скромнее
содержать: содержащие
спасаться: спастись
разоряться: разорялся
логичный: логичнее
требуетс: требуетс
орбита: орбите
соответствовать: соответствует соответствуют
ум: уму
стирани: стирани
кипричи: кипричи
фрыхх: фрыхх
компьютер: компьютеров компьютера
американский: Американского
собственно: Собственно
прикупать: прикуплю
шарнир: шарниру
ркн: ркн
приводить: приведи
подсвечивать: подсвечивать
двигать: двигали
прозвучать: Прозвучит
валюта: валюте
рассыпаться: рассыпаются
галерея: галерею
определять: определить
андройд: Андройд
ваттный: ваттном
посредством: Посредством
подстраиваться: подстраиваться
танец: танец
апло: апле
примеривалс: примеривалс
автоперевод: Автоперевод
отдел: отдела
кусков: кусков
сходиться: сходится
вставлять: вставить
глянцевый: глянцевой глянцевая
логично: логично
список: Список списке
герой: герои
грант: гранте
придумывать: придумывать
знакомиться: знакомиться
удача: удачи
автомобил: автомобил
местный: местная
лед: лед
эффект: эффекта эффектами
радиатор: радиаторов
сэр: Сэр
телеобъектив: телеобъектив
уныние: уныние
сервер: серверам
херить: херь
пасибо: пасибо
впечатление: впечатлением
уровень: уровень уровнем
едва: Едва
аляповатый: Аляповатый
ронять: ронять
танцевальный: танцевальном
автомобиль: автомобили автомобилем
добавление: добавлении
мочь: можешь могут
четыре: четыре
возить: возить
налицо: налицо
корень: корне корень
производительность: производительность
подумать: подумайте Подумаешь
несомненно: несомненно
отзывать: отозвал
миани: Миани
развидеть: развидеть
автообновление: автообновления
коль: коль
электронный: электронная электронна
тепло: тепла
надоедать: надоело
энергоэффективность: энергоэффективность
месяц: месяц
тэшьрэшх: тэшьрэшх
ситилинка: ситилинке
внизу: внизу
ранка: ранка
ровный: ровном
снапе: снапе
альтернативный: альтернативные
купе: купе
оружие: оружие
зима: зимы
прямо: Прямо
тумбочка: тумбочке
наверняка: Наверняка
силиконовый: силиконовым
насрать: насрано
жалко: Жалко
раз: разы
масса: массы Масса
цветопередача: цветопередача
зум: зум зуму Зум
весенний: весенних
температура: температурой температур температура
сфера: сфере
лобовой: лобовое
первичный: первичная
любить: любит
распространение: распространения
приколдесный: приколдесный
безопасный: безопаснее БЕЗОПАСНОЙ
выходить: вышли
бумажка: бумажки
сильный: сильное сильная
злоумышленица: злоумышлениц
пластиковый: Пластиковые
тип: типа
оставлять: оставит
цветовой: цветового цветовыми
пустой: пустые
операция: операцию
линейка: линейкой
некоторый: некоторое
никак: никак
адаптивный: адаптивная
болт: болт болта
ресурс: ресурсов
эбут: ЭБУТ
завал: завалом
гигант: гигантов
топить: топил топлю
учитывать: Учитывая учитывать учитывают
металлический: металлический
калибровать: калибровать
ахман: ахман
начинать: начать начавшей начинает начнет начнут начинала
параллельный: параллельный
выйфая: выйфаи
прозрачный: прозрачное прозрачными прозрачную
окскон: окскон
график: графику
япон: япона
рамка: рамками
следовать: следующих
собирать: собирает
влена: влена
фюсртшыш: фюсртшыш
объективный: объективным
адекватный: адекватной
себестоимость: себестоимости
посчитать: посчитать
навязывать: навязано
свежий: свежем
захудалый: захудалого
прочность: прочность
бар: баре
добираться: добрались
светосильный: светосильным
обычно: Обычно
китаец: китаец
покупка: покупок
мультипроцессор: мультипроцессорами
словить: слови
воздействие: воздействия
фотосессия: фотосессию
забегать: забегаю
распространять: распространены
пнуть: пнет
розовый: розового
экспериментировать: экспериментировать
ампер: ампер
ложиться: ложиться лег
проводник: проводником
лауреат: лауреата
скидка: скидках
офис: офиса офис
алюминиевый: алюминиевым алюминиевые
полезть: полезло
василий: Василий
видеозвонок: видеозвонков
последовательно: последовательно
складываться: складываются
огого: огого
запуск: запуске Запуск
выпуск: выпуском
штатив: штатива
лакшерить: лакшери
сообщение: сообщений
затычка: затычки
тот: той
разраба: разрабы
любитель: любителя
галакси: Галакси
ремонтопригодный: ремонтопригоден
повербанк: повербанка
комбинаци: комбинаци
динамический: динамического
насколько: Насколько
подводить: подводит
таскать: таскает
корпорация: корпораций
девать: деть девать
перегрев: перегрев
сегодня: Сегодня
молодость: молодость
выключать: выключать
решающий: решающей
составлять: составляет
труба: трубе трубу
рылми: рылми
огромный: огромное огромнейший
ионосфера: ионосферы
комната: комнате комнату
экспозиция: экспозицией
бесконтрольно: бесконтрольно
разумный: разумного
постоянный: постоянным
летучий: летучих
кабель: кабеля
хранение: хранения
лагерь: лагеря
вслух: вслух
зашифровывать: зашифровала зашифрован
предлагать: предложенной
нтересно: нтересно
повезти: повезет
плавность: плавность
девиз: девизом
категория: категория категорий
утечка: утечку
два: две двух
операционный: операционная
размещать: размещены
копить: Копить
значение: значений
тыканье: тыканий
отсутствлять: отсутстви
дубасить: дубасил
скончаться: скончался
яюя: яюя
элементарный: элементарной
деталь: деталь деталью
веб: веб
тив: тиве
расширять: расширить
площадка: площадках
получать: получаемых получившие
умирать: умирает
кастрировать: кастрированные кастрированном
оплачивать: Оплачиваю Оплачивая
рисунок: рисунке
продержаться: продержался
блокировать: блокирован
эплкар: эплкары
сюр: сюр
бот: Бот
сперва: сперва
яблочник: Яблочников
начальство: начальства
умудряться: умудрились
трассировка: трассировкой
локация: локации
заряжать: заряженной
ценный: ценно
подсказывать: Подскажу Подскажите
поток: потоком
нанокристаллический: нанокристаллического
чжухай: Чжухай
движок: движки
бодрый: бодрый бодрых
кормить: кормить
прекрасно: Прекрасно
собственный: собственная
растягивать: растянешь растянули
ремонт: ремонт ремонтом
принц: принце
офисник: офисник
захотеть: захотят
плоскоземельщиков: плоскоземельщиков
языковый: языковую
симбиоз: симбиозу
оперативка: оперативку оперативки
выдача: выдачи
доходить: дошла
поинтереснееаня: поинтереснееаня
персонализация: персонализации
иктор: иктор
нагрев: нагрева
сговор: сговор
пополняться: пополнилась
шумоподавление: Шумоподавление
владеть: владею
тупой: тупые
монолитный: монолитным
фон: фона
убеждать: убеждаешь
странно: странно
экрпный: экрпном
отключать: отключенных отключаемым
оралка: оралка
краска: краски
край: край
практик: практики
умелец: умельцы
функционал: функционал
сосед: соседях
ссср: СССР
щека: щеки
история: историями
препарировать: Препарировать
указанный: указанный
верхний: верхней верхняя
цена: ценой цену
микросхема: микросхемы
гигагерцевый: гигагерцевые
брежневка: брежневках
отличительный: Отличительной
превышать: превышающим
красавчик: красавчика
замечательно: замечательно
балл: балла
научать: научила
радеон: радеон
общаться: общаться
гпд: гпд
сплит: сплит
ром: роме
бредовой: бредовая
конкурировать: Конкурирующую
консолька: консольку
присматривать: присмотрю присмотреть
воронеж: Воронеж
пилот: пилот
охото: охото
драйвер: драйверы
подобный: подобной
сидитс: сидитс
оже: оже
нцевой: нцевой
существующий: существующей
лопаться: лопалось
офт: офт
украсть: украли
смешной: смешной
легион: легионе
лотерея: лотереей
ссыль: ссыль
покрасочный: покрасочная
существовать: существуют существовать
особенность: особенность ОСОБЕННОСТИ
тыр: тыр
переезд: переезда
засилье: засилья
самса: Самса
бер: бер
надстройка: надстройкой
смущать: смущают
сеть: СЕТЬ
схема: схема
метод: методами
истишеть: истишев
сменить: сменили
замена: замены замену
макса: максы
огород: огороде
вебкамера: Вебкамера
фотка: фотку
роскошь: роскошь
честный: Честном
гибкий: гибкого
мягкий: мягкое мягкий
переезжать: переехали
продавливать: продавливаемые
вино: вина
адам: Адам
фактура: фактура
сахар: сахара
независимый: независимое
нередко: нередко
восточный: Восточной
анджелес: Анджелеса
создание: созданию создания
попользоваться: попользуетесь попользуюсь
экспертиза: экспертиза
эталонный: эталонным
телеметрия: телеметрии
мажор: мажора
выращивать: выращивают
вынести: вынести
винд: Винде винда
высокомерие: Высокомерие
толика: толику
быстренько: быстренько
переменная: переменной
геймер: Геймеры
охватывать: охватывать
пропорция: пропорций
печаль: печаль
сноудно: Сноуден
пища: пища
дык: Дык
личный: личный
тао: тао
посидеть: Посидел
фолд: Фолды
ветер: ветра
ставить: ставлю
дискомфорт: дискомфорт
трудно: трудно
ватт: ваттам
недосягаемый: недосягаемых
форум: форуме
разный: разный
поистине: поистине
аудиосистема: аудиосистем
конвертер: конвертере
импорт: импорту
видимо: Видимо
бразуер: бразуера
алиса: Алиса
банальность: банальность
ильм: ильмы
состоять: состоит
капли: каплями
трансфлективный: трансфлективный
фиксатор: фиксатор
злоумышленник: злоумышленники
нижний: нижней
локализация: локализации
сказываться: сказался
бомж: бомж
прочитывать: прочитайте
подскакивать: подскочило
фантастика: фантастика
поставлять: поставить поставь
погубить: погубило
утыкивать: утыкана
зяомить: зяоми
фшчрщэхо: фшчрщэх
провал: провал провала
миллиард: миллиардам
предоставляться: предоставляются
аналитик: аналитики Аналитики
фотик: фотик
надуманный: надуманные
ухудшать: ухудшают
район: района
регистрация: регистрацию
итоговый: итогового
шус: шус
дизайнерский: дизайнерские
тролстор: тролстор
кладбище: Кладбище
смотреться: смотрелось
апгрейд: апгрейдов апгрейд
чеек: чеек
прочий: Прочие
пополнение: пополнения
квеста: квеста
товарный: товарный товарно
дома: дома
визуальный: визуальные
реакция: реакции
иначе: иначе
расписывать: расписал
соц: соц
стационарный: стационарным
матовый: Матовое
текущий: текущего
данный: данную
фиолетовый: фиолетово
тепловой: тепловые
поставляться: поставляется
стеклянный: стеклянной стеклянном
продуктовый: продуктовая
стереоскопический: стереоскопического
сламывать: сломит
полезность: полезности
творить: ТВОРИТЕ
недостаточный: недостаточного
квадрат: квадратами
компенсировать: компенсировать
парольчик: парольчики
засовывать: засунуть
рчрф: рчрф
плюшка: плюшки
осмос: осмосом
игнорировать: игнорируешь игнорировать
браузер: Браузер
тело: тело
встречать: встречает
вид: виду
широкий: широкого Широкий
геймпада: геймпада
детишки: детишки
прекращение: прекращения
гоночный: гоночные
практичный: практичный
опасный: опасна
разработка: разработку
занятный: занятный
плеер: плеера плееры
зимний: зимних
движение: движения
массив: массив
рука: рука
отвлекаться: отвлекаясь
прогнать: Прогнала
весомый: весомое
полагать: положили
веко: веки
использовать: используя
строка: строк
обфускация: обфускацией
достижение: достижения
виджет: виджет виджетов
оптимальный: оптимальной
проект: проектами
планир: планиру
мак: Мак
клип: клип
нирвана: нирване
занавес: занавес
скорый: скором
вперед: вперед
рамочка: рамочку
трехлетний: трехлетней
квалка: квалке
автор: автора
логика: логика
фотография: фотографией
побивать: побитого
древний: древняя
теплотрубка: теплотрубках
понятный: понятная
тизирить: тизирить
двусторонний: Двусторонняя
лавное: лавное
троттлинг: троттлинга
интересный: интереснее
европейский: европейских
резак: резак
позаботиться: позаботились
стимулировать: стимулировать
школьный: школьных
высокий: высокую высокая
воздух: воздуха
наличный: наличные
перепродавать: перепродать
запад: западу
бирюзовый: бирюзовый
счастливый: счастлив
автоцензор: автоцензор
друг: Друзья Друг друга
птица: птица
энергоэффективный: энергоэффективных
попугай: попугаям
троллинг: троллинг
маркетинг: маркетинг
звонить: звонил
агент: агент
комфортно: комфортно
доля: Доля
предназначать: предназначенный
квадрокамера: квадрокамерой
приступать: приступим
оторопь: оторопь
погремучий: погремучий
сторонний: сторонний Сторонний
вибро: вибро
поднести: поднести поднесли
аудитория: аудитории
утвердить: утвердило
видеозапись: видеозаписью
рабочий: Рабочий
бесплатно: Бесплатно
оболочка: оболочкой оболочку
себя: собой
глазок: глазками
замечать: замечаете заметили
вводный: вводные
фаенд: фаенд
ойфон: ойфонов
ирония: Иронии
менша: менше
забагованный: забагованную забагованные
конский: конский
включение: включения
народ: народу
мало: мало
возмущать: возмущены
кой: кое кой
пытатьс: пытатьс
каплевидный: каплевидный
эпол: Эпола
поляк: поляк
гамма: гаммы
навигация: навигации
смеяться: смеялись
пригождаться: пригодиться
своб: своб
очередной: очередное
полуоткрытый: полуоткрыт
компань: компани
земля: земля
прибор: прибор
гектар: гектар
тонкий: тонкие тонких
бендер: Бендер
тупить: тупили
уходить: уйдут
мвидео: мвидео
солидарный: Солидарен
алиуллов: Алиуллов
приостановка: приостановки
изгонять: изгонять
недорогой: недорогая
цензура: цензура
сотрудник: Сотрудник
превосходный: превосходном
космонавт: космонавт
разрабатывать: разработанный
команда: команд
комбо: комбо
комплектный: комплектного комплектный Комплектный
намечаться: наметился
чат: чатов
прмя: прмя
хайпануть: хайпануть
виделетать: виделетели
мутно: мутно
маловато: маловато
кулер: кулеров кулером
подэкранный: подэкранная
яркость: яркость
наплакать: наплакал
производительный: производительней производительного
матричный: матричного
стереодинамика: стереодинамика
электрочайник: электрочайник
жалоба: жалоб
подготовить: подготовил
программный: программных программное
убивец: убивца
отрыв: отрывом
реактор: реактор
разрешение: Разрешение
выжигать: выжигает
задирать: задрали
дигма: дигма
обслуга: Обслуга
оформление: оформлении оформления
вырастать: вырастали вырастает
фил: фила
смекалка: смекалки
зык: зыке
салями: салями
недостаточно: недостаточно
который: которые
проблемный: проблемном
уступать: уступающие уступает уступают
снимок: снимков
подписка: подписки подписок подписку
срабатывание: срабатывания
реальный: реальном
итд: итд
дос: досом
ермей: ермей
ыра: ыра
сантиметр: сантиметров
ключ: ключи
испарительный: испарительная
трансмиттер: трансмиттер
менять: менять меняйте
обзор: обзорам обзоры
новый: Новую
резиновый: резиновый
руч: руче
голосовать: голосую голосовать
заблочить: заблочить
падение: падения
пользователь: пользователям
рано: рано
жизнеспособный: жизнеспособен
тример: тример
тгк: ТГК
море: моря
неприемлемый: неприемлемым
комментировать: комментирует
зку: зку
рынок: рынке
кастомный: кастомной
телефон: телефон
полоса: полосы полоса
техпроцесс: техпроцессы
охота: охоте
зрелищный: зрелищным
подавлять: подавляющее
автономность: автономность
занимать: занято
облако: облако
интересовать: интересует
поход: походе
ножик: ножик
сертификация: сертификацию
неважно: неважно
заточить: заточенного
задник: задниками задником
агриться: агриться
глубина: глубину глубиной
отечественный: отечественный
милый: мил
мелочь: мелочи
кремний: кремний
ведомство: ведомства
молчать: Молчу
панасоник: Панасоники
идеапад: идеапад
сталкиваться: сталкиваются столкнулся
выживач: Выживач
видеокарта: видеокарту
погасить: погашенным
дисциплина: дисциплин
комментатор: комментатор
егс: егс
срулкер: срулкер
кабриолет: кабриолеты
назначение: назначению
визуально: Визуально
фшруюэр: фшруюэры
осуждать: осуждаю
уродски: уродски
шайба: шайбы
бить: били
светофорик: светофорик
икранчик: икранчик
мощный: мощные мощной
яхта: яхту
положение: положение
доброта: доброте
антиквариат: антиквариат
андроид: Андроиде Андроиду
ладенька: ладенька
глобальный: глобальный
свидетель: свидетель
релиз: Релиз релизе релиза
дешевка: дешевке
уфх: уфх
беларусь: беларусь
огласно: огласно
соотношение: Соотношение соотношения
минимальный: минимальные минимального минимальных
позиция: позицию
увеличиваться: увеличатся
накруточка: накруточка
божественный: божественный
бюджетка: Бюджетки
инкпад: инкпадов
гзяоми: Гзяоми
сначала: Сначала
открытка: открытки
мессенжер: мессенжеров
пошло: пошло
обозревать: обозревать
изучать: изучил
институт: института
упускать: упустить
тремитс: тремитс
сидеть: сидящими сидит
сверхпрочный: сверхпрочный
жесткий: жестким
куча: кучи
доставать: Достал
удастс: удастс
загружаться: загрузился
милот: милота
поменяться: поменялось
подробно: Подробнее
ббк: Ббк
душитьс: душитьс
мера: мер
вернуться: вернется
такой: Таких
выписывать: выпишут
управление: управления
вадим: Вадим
номерной: номерной
перебезчик: перебезчиков
страна: страны
постановщик: Постановщик
лето: Летом
регулироваться: регулируется
лапа: лапу
толковый: толковый
следствие: следствием
чистый: чистую
казахстан: Казахстана
выстреливать: выстрелил
алексей: Алексей
подрастать: подросли
водопад: водопаде
упоминание: упоминания
эрч: эрч
хорошо: получше
отличный: Отличные отличные
некий: некое
оранжевый: оранжевый
позвол: позвол
привлечение: привлечения
тактика: тактика
съемка: съемок
конструкци: конструкци
мошеннический: мошеннической
точность: точность
совершать: совершите
вдобавок: вдобавок
вентиль: вентиля
поспорить: поспоришь поспорить
прижимаетс: прижимаетс
мерзопакостный: мерзопакостно
зашивать: зашито
женатый: женатые
давинчи: давинчи
нейронка: нейронкой
кровный: кровные
ежедневно: ежедневно
открытый: открытое
транзакция: транзакции
защитный: защитным
сравнимый: сравнима
акустический: акустическом
раскидывать: раскидали
уголок: уголках
маттье: Маттьего
фирменный: фирменную
моника: моник
середина: середину
терять: теряя
роскомнадзор: роскомнадзор
сообщать: сообщили
нога: ноги
гладкий: гладкая
неудобство: неудобство
поесть: поели
простой: простыми
ремонтопригодность: ремонтопригодностью
эмоция: эмоции
выгодный: выгодного
наличные: наличных
борцун: борцунам
привлекательность: привлекательности
ржа: ржу
европеец: Европеец
наглый: наглую нагл
всякий: всякими
ака: аки
смутный: смутные
тяжело: потяжелее
вопрос: Вопросов
считывань: считывани
эмулятор: эмулятора Эмуляторы
ошибка: ошибка
бинокуляр: бинокуляра
люфтит: люфтит
натягивать: натянут
приносить: приносит
печальный: печальные
носок: носки
плотно: плотно
сабж: сабже
энергосбережение: Энергосбережение
безвременный: безвременного
воспринимать: воспринимают
вирус: Вирусы
главное: Главное
козел: козла
перл: перлы
переходить: переходят
разгонять: разгоняете
меряться: меряться
алгоритм: алгоритм
призывать: призвано
специализированный: специализированной
убожественный: убожественными
рваться: рвитесь
дверь: дверь
кромка: кромку
экокожий: экокожа
сопровождение: сопровождения
чехол: чехлом чехла
родитель: родителям
возрастать: возросла
телега: телега
множество: множество
значительный: значительные
ругать: ругали
страивать: строю
адресовать: адресованную
щий: щий
благо: Благо
катушка: катушки
вправо: вправо
остаточный: остаточной
чтение: чтение
уведомлень: уведомлени
напуруалить: напуруалить
устаревать: устаревших
защита: защитой
парта: парту
сенсор: сенсор
таить: таят
тхышъюыхяэ: тхышъюыхяэ
использоваться: использовались
мизер: мизера
чпда: чпда
заглушка: заглушек
требование: требование
ряд: рядах
нечаянно: нечаянно
сигнал: сигналом
торчать: торчащие
сторона: стороной
офисный: офисному
утро: утро
шфх: шфх
видео: ВИДЕО
нариканье: нариканий
эргономика: эргономикой эргономики
улетать: улетел
перетекать: перетекать
зарабатывать: зарабатывающему
отрабатывать: отработали
пользовательский: пользовательских пользовательский
род: род роде
майнить: майнить
эффективность: эффективностью
стремитс: стремитс
знакомство: знакомстве
эшелон: эшелон
квест: квест
небольшой: небольшим невелики небольшое
продаваться: продавалось
изврат: изврат
обвести: Обвести
бесить: бесит
даром: даром
рония: ронии
материнский: материнской
проверять: проверяйте
обходиться: обходятся
ламер: ламеров
сиська: сисек
просыпаться: Просыпаемся
изначальный: изначальной
подчеркивать: подчеркнуть
известно: известно
агрессивный: агрессивный
хватить: хватит
попадать: попадает
применение: применения
жалеть: жалею
самостоятельный: самостоятельного
делл: Делл
сиря: Сири
меркнуть: меркнет
наименование: наименования
ремейк: ремейку
валяться: валяется
отливать: отливают
мечта: Мечты
лукавить: лукавит
смарта: смарта
файрбат: файрбат
долбать: долбанных
свинство: свинства
чип: чипе чипы
лчрэшцр: лчрэшцр
велосипед: велосипеда
грозить: грозит
потенциальный: потенциальному
намного: Намного
длина: длиной
нанометровый: нанометровый
наездиться: наездился
разряжать: разряжал
стима: Стиме
елиз: елиз
предостерегать: предостерегают
сбрасывать: сбрасывать
увы: увы
дополнять: дополненный
скорость: скоростью
видеочасть: видеочасти
заливка: заливкой
проходить: проходим проходящей
небо: небо
замудрить: замудрили
фтр: фтр
ярко: ярко
макпро: макпро
проприетарный: проприетарного
пока: Пока
вай: вай
промах: промах
уродец: уродцы
ядро: ядре
брэнд: брэнд
цвет: цвету цвете
реверсивный: реверсивной
наш: наше наш
отсасунг: отсасунга
особняком: особняком
процесс: процесс
дословно: дословно
переломать: переломал
клей: клеем
микрософт: микрософта
фаер: Фаер
партия: партию
плотность: плотность
изготавливать: изготовлен
бессильный: бессильными
выпускатьс: выпускатьс
многочисленный: многочисленных
обратный: обратный
типоразмер: типоразмера
ноут: ноута
оборудование: оборудование
красавица: красавицей
тупо: Тупо
пипирка: пипирка
доставка: доставкой
хакинтош: Хакинтош
эпстор: эпстора
рация: Рация
чудовище: чудовище
тесто: тестами
потирать: потер
материнка: материнка
фунционал: фунционалом
диванный: диванный
яюыэхэ: яюыэхэ
полдела: полдела
сломать: сломал
зарядка: зарядок
блокировка: блокировку
пятилетний: пятилетний
выводить: вывел
игровой: игровым
блондинка: блондинка
экземпляр: экземпляра
срок: срок
присерный: присерном
интерес: интересов
интеллектуальный: интеллектуального
прежний: прежнему
март: март
предыдущий: предыдущее
тшфюь: тшфюь
великий: великая
причина: причине
заряжаться: заряжаются
победитель: победителя
подсветка: подсветки
подсаживать: подсаживает
изменять: изменить
регресс: регресс
премиальный: премиальной
отваливаться: отваливался
стор: стор
синхронизация: синхронизацию
дотрагиваться: дотронуться
хамелеон: хамелеона
маркировка: маркировку
царский: царскими
пространство: пространствах
способ: способы
сбер: Сбер
типо: типо Типо
ярый: ярый
поломка: поломок
сьемки: сьемках
образованность: образованности
жто: жто
старый: старая
фокусировка: фокусировки
кратце: кратце
ноу: ноу
лавный: лавный
оставаться: оставался
перечесть: перечесть
бит: бит
дурно: дурно
яблочный: Яблочная
успех: успех
задействовать: задействованы
двигатель: двигатель
садиться: садится
потребоваться: потребуется
кропотливый: кропотливая
багрепорт: багрепорт
святой: святые
главный: главная
запотевать: запотела
интеграция: Интеграции
анонс: анонсом
трансформер: трансформер
истина: истину
ремонтировать: ремонтировать
спешить: спешим
асус: асусы
головастик: головастика
критика: критики
просаживать: просадило
глаз: глазами
дождаться: дождаться
робопс: робопсу
предзаказ: предзаказу
протирани: протирани
аккант: акканты
возможный: возможных
программист: программист
незаменимый: незаменимым
субъективный: субъективный
танцевать: танцевать
кривой: Кривые
фейк: фейки
акторио: акторио
выкидывать: выкинет
херомить: хероми
чемодан: чемоданы
заходить: заходили
вызывать: вызывают
зато: зато
реагировать: реагировать
сударь: Сударь
фанат: фанатам
музыка: Музыка
тарт: тарт
кастомизация: Кастомизация
евросоюз: Евросоюза
эютюь: эютюь
монитор: мониторами
написать: напишу
ого: ого
компдектующий: компдектующих
симметричный: симметричными
напролом: напролом
скукотище: скукотища
райзен: райзена
пароль: пароли
олег: Олег
мысль: мысль
прекращать: прекратила
карта: карты
связанный: Связано
среда: средой
собсвенный: собсвенный
протокол: протоколами
софт: софту
блокнот: блокнот
построенный: построенна
сомнительно: сомнительно
задеть: задел
запоминаться: запомнился
скоростной: скоростными
приятный: приятном
пополам: пополам
подарок: подарок
коммент: комментом
грань: гранями
размытый: размытым
частичный: частичное
зрень: зрени
камерофон: камерофон
промокод: промокоды
глянуть: глянуть
одноклеточный: одноклеточной
смотреть: Смотрят
переключать: переключил
вебок: вебка
распаивать: распаянные
вивобук: вивобуками
царь: царь
высасывать: высосали
айзен: айзен
подключение: ПОДКЛЮЧЕНИЯ
коррозия: коррозии
извинять: Извините
нулевой: нулевых
советский: советской
очистка: очистки
откровенный: откровенна
неисправный: неисправный
выносить: выносить
дезигн: дезигн
ген: ген
